11111111111111111111111111111111111
10100101001000001010010000000101011
10100100101010100010010000000101011
1P0000000C00C0000000000000000000C11
11111111111111111111111111111111111
